##########
# @ #X# .#
# O #=#  #
# #    # #
# # ## # #
#        #
# # ## # #
# # ## # #
#    Y   #
##########
