###########
#~~~~X~~~~#
#~~~~~~~~~#
#~~~~~~~~~#
#    O    #
#   O O   #
#         #
#    Y    #
###########
