###########
#~~~~X~~~~#
#~~~~~~~~~#
#~~~~~~~~~#
#    O    #
#   O O   #
#    Y    #
#         #
###########

###########
#~~~~X~~~~#
#~~~~~~~~~#
#~~~~~~~~~#
#    O    #
#   OYO   #
#         #
#         #
###########

###########
#~~~~X~~~~#
#~~~~~~~~~#
#~~~~ ~~~~#
#    Y    #
#   O O   #
#         #
#         #
###########

###########
#~~~~X~~~~#
#~~~~~~~~~#
#~~~~ ~~~~#
#   Y     #
#   O O   #
#         #
#         #
###########

###########
#~~~~X~~~~#
#~~~~~~~~~#
#~~~~ ~~~~#
#  Y      #
#   O O   #
#         #
#         #
###########

###########
#~~~~X~~~~#
#~~~~~~~~~#
#~~~~ ~~~~#
#         #
#  YO O   #
#         #
#         #
###########

###########
#~~~~X~~~~#
#~~~~~~~~~#
#~~~~ ~~~~#
#         #
#   YOO   #
#         #
#         #
###########

###########
#~~~~X~~~~#
#~~~~~~~~~#
#~~~~ ~~~~#
#         #
#    OO   #
#   Y     #
#         #
###########

###########
#~~~~X~~~~#
#~~~~~~~~~#
#~~~~ ~~~~#
#         #
#    OO   #
#    Y    #
#         #
###########

###########
#~~~~X~~~~#
#~~~~~~~~~#
#~~~~ ~~~~#
#    O    #
#    YO   #
#         #
#         #
###########

###########
#~~~~X~~~~#
#~~~~~~~~~#
#~~~~O~~~~#
#    Y    #
#     O   #
#         #
#         #
###########

###########
#~~~~X~~~~#
#~~~~ ~~~~#
#~~~~Y~~~~#
#         #
#     O   #
#         #
#         #
###########

###########
#~~~~X~~~~#
#~~~~Y~~~~#
#~~~~ ~~~~#
#         #
#     O   #
#         #
#         #
###########

###########
#~~~~Y~~~~#
#~~~~ ~~~~#
#~~~~ ~~~~#
#         #
#     O   #
#         #
#         #
###########

