############
#X  #      #
###=# #### #
#   #    # #
# # # ## # #
# #   #    #
# ##### ####
#          #
#### ####  #
#    #  #  #
#### #  #  #
#      ### #
#  # #     #
#### # ### #
#. O # # Y #
############
