#######
#YO O #
#  O  #
#  O  #
#  ~  #
#######
