#######
# O O #
#Y O  #
#  O  #
#  ~  #
#######

#######
# O O #
# YO  #
#  O  #
#  ~  #
#######

#######
# O O #
#  O  #
# YO  #
#  ~  #
#######

#######
# O O #
#  O  #
#  O  #
# Y~  #
#######

#######
# O O #
#  O  #
#  O  #
#  ~  #
#######

