######
##X###
##=###
## ###
#.O  #
#### #
#### #
#### #
##Y  #
######
