######
##X###
##=###
## ###
#.O  #
#### #
#### #
#### #
## Y #
######

######
##X###
##=###
## ###
#.O  #
#### #
#### #
#### #
##  Y#
######

######
##X###
##=###
## ###
#.O  #
#### #
#### #
####Y#
##   #
######

######
##X###
##=###
## ###
#.O  #
#### #
####Y#
#### #
##   #
######

######
##X###
##=###
## ###
#.O  #
####Y#
#### #
#### #
##   #
######

######
##X###
##=###
## ###
#.O Y#
#### #
#### #
#### #
##   #
######

######
##X###
##=###
## ###
#.OY #
#### #
#### #
#### #
##   #
######

######
##X###
## ###
## ###
#OY  #
#### #
#### #
#### #
##   #
######

######
##X###
## ###
##Y###
#O   #
#### #
#### #
#### #
##   #
######

######
##X###
##Y###
## ###
#O   #
#### #
#### #
#### #
##   #
######

######
##Y###
## ###
## ###
#O   #
#### #
#### #
#### #
##   #
######

